 NO ./textures/missing.png
 SO ./textures/missing.png
 WE ./textures/missing.png
 EA ./textures/missing.png

 F 150,130,110
 C 25,150,200


11111111111111
10000001000001
10000001000001
100S0001000001
10000001000001
10000001000001
11101111101111
11000000000001
11111111111111
