 NO ./textures/missing.png
 SO ./textures/missing.png
 WE ./textures/missing.png
 EA ./textures/missing.png

 F 150,130,110
 C 25,150,200

        1111111111111111111111111
        1000000000110000000000001
        1011000001110000000000001
        1001000000000000000000001
111111111011000001110000000000001
100000000011000001110111111111111
11110111111111011100000010001
11110111111111011101010010S01
11000000110101011100000010001
10000000000000001100000010001
10000000000000001101010010001
1100000111010101111101111101111
11110111 1110101   100000000001
11111111 1111111   111111111111
