 NO ./textures/cobblestone.png
 SO ./textures/cobblestone.png
 WE ./textures/moss.png
 EA ./textures/moss.png
 D1 ./textures/door1.png
 D2 ./textures/door2.png
 D3 ./textures/door3.png
 D4 ./textures/door4.png
 D5 ./textures/door5.png
 D6 ./textures/door6.png
 D7 ./textures/door7.png

 F 150,130,110
 C 25,150,200

        1111111111111111111111111
        1000000000110000000000001
        1011000001110000000000001
        1001000000000000000000001
111111111011000001110000000000001
100000000011000001110111111111111
11110111111111011100000010001
11112111111111011101010010S01
11000000110101011100000020001
10000000000000020000000010001
10000000000000011101010010001
1111211111010101111101112121111
11110111 1110101   100000000001
11111111 1111111   111111111111
