 NO ./textures/holy_wall2.png
 SO ./textures/holy_wall2.png
 WE ./textures/holy_wall1.png
 EA ./textures/holy_wall1.png
 MO ./textures/monster.png
 D1 ./textures/door_lvl3_1.png
 D2 ./textures/door_lvl3_2.png
 D3 ./textures/door_lvl3_3.png
 D4 ./textures/door_lvl3_4.png
 D5 ./textures/door_lvl3_5.png
 D6 ./textures/door_lvl3_6.png
 D7 ./textures/door_lvl3_7.png
 E1 ./textures/exit_lvl3_1.png
 E2 ./textures/exit_lvl3_2.png
 E3 ./textures/exit_lvl3_3.png
 E4 ./textures/exit_lvl3_4.png
 E5 ./textures/exit_lvl3_5.png
 E6 ./textures/exit_lvl3_6.png
 E7 ./textures/exit_lvl3_7.png

 F 90,80,100
 C 60,60,60

1111111111111111111111111
100010000010000010M000001
1000100000100000101101101
1000100000100000100000001
1M121112111112111000011M1
1110000000000000200000001
1000000000000000111111111
10001111111110001
10001111100010001
100010M0100010001
10001000100010001111111
10001121121110001000001
1000000000002000200W001
10001000000010001000001
100011111111100011111111111
100000000000000000000000001
100000000000000000100001001
100001000000000010000000001
101000000000000000010001001
101000000000000010010000001
100001000000000000000001001
100000000000000000100000001
100011111111111110001110001
1000111111111111100000M0001
100020000011111111111111111
100012121211111111001001001
1000111111111111110010M1001
100020000M11111111001001001
100012121211111111001001001
100011111111111111001001001
100002000000000000000000001
100001001001001001001001001
100001001001001001001001001
100001011211111001001001001
100001011000011001001001001
1000010110M0011001001001001
100001011111111001001001001
100001001001001001001001001
100001001001M01001001001001
100001001001001001001001001
100002000000000000000000001
100001111111111111111111111
100002000000000000000000001
100001001001001001001001001
100001001001001001001001001
100001001M010010010M1001001
100001001001001001001001001
100001001001001001001001001
100001001001001001001001001
1000010010010M1001001001001
100001001001001001001001001
100001001001001001001001001
100002000000000000000000001
100011111111111111111111111
10001M001000111111000000001
100011121121111111000000001
100010000000100001001111001
100011111211100001000000001
100000000000000002000000001
100011111111100001111101101
100010M01111100001111100001
100020001111100001111100001
100011111111100001111111111
10000000000000000200P1
1000000000000000011111
111211111111112111111111111
100000001000000001100M00111
101001001000000001100000001
101001001001001000000000001
100000001001001001001001001
101001001001001001001001001
101001001001001001001001001
100000001001001001001001001
101100001001001001001001001
10M000001000000000000000001
111111111111111111111111111
