 NO ./textures/cobblestone.png
 SO ./textures/cobblestone.png
 WE ./textures/moss.png
 EA ./textures/moss.png
 MO ./textures/monster.png
 D1 ./textures/door1.png
 D2 ./textures/door2.png
 D3 ./textures/door3.png
 D4 ./textures/door4.png
 D5 ./textures/door5.png
 D6 ./textures/door6.png
 D7 ./textures/door7.png
 E1 ./textures/exit1.png
 E2 ./textures/exit2.png
 E3 ./textures/exit3.png
 E4 ./textures/exit4.png
 E5 ./textures/exit5.png
 E6 ./textures/exit6.png
 E7 ./textures/exit7.png

 F 80,60,40
 C 45,75,50

11111111111111111
11111111112111111
11111111110111111
1P11P11M11011P111
10110110110110111
1011M11011011M111
12112112112112111
10000000000000001
10000000000000001
101000100000100M1
11112111121111211
10000000001000001
100000011M1000001
10000000111000001
11111112111111211
1M000010010010001
11101010000020001
10001000010010001
12111111211112111
10000010000010001
10001010010020001
10101M10010M100M1
11121111211112111
10000000000000001
10000000101000001
12111121211121111
100M1000011000011
10001000011000011
10001M10011010011
11211111211112111
10000000000000001
10000000000000001
10000000000000001
10000000000000001
10000000000000001
1000000N000000001
11111111111111111
