 NO ./textures/moss.png
 SO ./textures/moss.png
 WE ./textures/bloody.png
 EA ./textures/bloody.png

 F 80,60,40
 C 45,75,50

      11111
11111110001111
10000000100001
10010011111001
100000000110011111111
1111111000110000000011
      1100010000000001
11111111101111110011111
10000111000001000010001
10E00001010001000010111
100000010001011000001
111100010100011111111
10000001000001
11101111101111
11000000000001
11111111111111
