 NO ./textures/cobblestone.png
 SO ./textures/cobblestone.png
 WE ./textures/moss.png
 EA ./textures/moss.png
 MO ./textures/monster.png
 D1 ./textures/door1.png
 D2 ./textures/door2.png
 D3 ./textures/door3.png
 D4 ./textures/door4.png
 D5 ./textures/door5.png
 D6 ./textures/door6.png
 D7 ./textures/door7.png
 E1 ./textures/exit1.png
 E2 ./textures/exit2.png
 E3 ./textures/exit3.png
 E4 ./textures/exit4.png
 E5 ./textures/exit5.png
 E6 ./textures/exit6.png
 E7 ./textures/exit7.png

 F 150,130,110
 C 25,150,200

        1111111111111111111111111
        1000000000110000000000001
        1011000001110000000000001
        1001000000000000000000001
111111111011000001110000000000001
10000000001100000111011111P111111
11110111111111011100000010001
11110111111111022201010020001
11000000110101011100000010001
10000000000000001100000010001
1E000000000000000000M10010001
1100000111010101111101111101111
11110111 1110101   100000000001
11111111 1111111   111111111111
