 NO ./textures/cobblestone.png
 SO ./textures/cobblestone.png
 WE ./textures/moss.png
 EA ./textures/moss.png
 MO ./textures/monster.png
 E1 ./textures/exit1.png
 E2 ./textures/exit2.png
 E3 ./textures/exit3.png
 E4 ./textures/exit4.png
 E5 ./textures/exit5.png
 E6 ./textures/exit6.png
 E7 ./textures/exit7.png

 F 150,130,110
 C 25,150,200

        1111111111111111111111111
        1000000000110000000000001
        1011000001110000000000001
        1001000000000000000000001
111111111011000001110000000000001
10000000001100000111011111P111111
11110111111111011100000010001
11110111111111011101010010S01
11000000110101011100000010001
10000000000000001100000010001
10000000000000001101010010001
11000001110101011111011111M1111
11110111 1110101   1M0000000001
11111111 1111111   111111111111
